20000000000000000000000000000000000000000000000000000000000000000000000000000000000000000000000000000000000000000000000000000000000000000002
20000000000000000000000000000000000000000000000000000000000000000000000000000000000000000000000000000000000000000000000000000000000000000002
20000000000000000000000000000000000000000000000000000000033300000000000000000000000000000000000000000000000000000000000000000000000000000002
20000000000000000000000000000000000000000000000000000000033300000000000000000000000000000000000000000000000000000000000000000000000000000002
20000000000000000000000000000000000000000000000000000000033300000000000000000000000000000000000000000000000000000000000000000000000000000002
20000000000000000000000000000000000000000001111111111111111111111000000000000000000000000000000000000000000000000000000000000000000000000002
20000000000000000000000000000000000000011000000000000000000000000000000000000000000000000000000000000000000000000000000000000000000000000002
20000000000000000000000000000000000000000000000000000000000000000000000000000000000000000000000000000000000000000000000000000000000000000002
20000000000000000000000000000000000110000000000000000000000000000000000000000000000000000000000000000000000000000000000000000000000000000002
20000000000000000000000000000000000000000000000111111110000000000000111000000000000000000000000000000000000000000000000000000000000000000002
20000000000000000000000000000000110000000000000200000030000000000000000000000000000000000000000000000000000000000000000000000000000000000002
20000000000000000000000000000000000000000000000200000030000000000400000000000000000000000000000000000000000000000000000000000000000000000072
21111111111111111101111100011111111111111111111215551121111111111211111111111111111111111111111111111111111111111111111111111111111111111112
22222222222222222202222200022222222222222222555555522222222222222222222222222222222222222222222222222222222222222222222222222222222222222222
22222222222222222202222200022222222222222555555522222222222222222222222222222222222222222222222222222222222222222222222222222222222222222222
22222222222222222202222200020035522222255555522222222222222222222222222222222222222222222222222222222222222222222222222222222222222222222222
22222222222222222202222200022222552255555552222222222222222222222222222222222222222222222222222222222222222222222222222222222222222222222222
22222222222222222202222200022222255255555222222222222222222222222222222222222222222222222222222222222222222222222222222222222222222222222222
22222222222222222202222200022222225555522222222222222222222222222222222222222222222222222222222222222222222222222222222222222222222222222222
22222222222222222202222200022222222222222222222222222222222222222222222222222222222222222222222222222222222222222222222222222222222222222222
22222222222222222202222200022222222222222222222222222222222222222222222222222222222222222222222222222222222222222222222222222222222222222222
22222222222222222202222200022222222222222222222222222222222222222222222222222222222222222222222222222222222222222222222222222222222222222222
22222222222222222242222244422222222222222222222222222222222222222222222222222222222222222222222222222222222222222222222222222222222222222222
22222222222222222222222222222222222222222222222222222222222222222222222222222222222222222222222222222222222222222222222222222222222222222222
22222222222222222222222222222222222222222222222222222222222222222222222222222222222222222222222222222222222222222222222222222222222222222222
22222222222222222222222222222222222222222222222222222222222222222222222222222222222222222222222222222222222222222222222222222222222222222222
22222222222222222222222222222222222222222222222222222222222222222222222222222222222222222222222222222222222222222222222222222222222222222222
22222222222222222222222222222222222222222222222222222222222222222222222222222222222222222222222222222222222222222222222222222222222222222222
22222222222222222222222222222222222222222222222222222222222222222222222222222222222222222222222222222222222222222222222222222222222222222222
